B,B,B,B,B,B,B,B,B,
B,B,B,B,B,B,B,B,B,
B,B,5,B,B,4,B,B,B,
B,2,B,B,B,B,B,B,B,
B,1,B,B,B,B,B,B,B,
B,B,B,1,B,B,B,B,B,
B,B,B,B,B,B,B,B,B,
B,3,B,B,B,B,G,B,B,
B,B,B,B,B,B,B,B,B