B,B,B,B,B,B,B,B,B,B,
B,B,B,2,B,B,B,B,B,B,
B,B,B,B,1,B,B,B,B,B,
B,B,1,B,B,B,B,B,B,B,
B,B,B,1,B,B,G,B,B,B,
B,B,B,B,1,B,B,B,B,B,
B,B,B,B,1,B,1,B,B,B,
B,B,B,B,B,B,B,1,B,B,
B,B,B,B,B,1,B,B,B,B,
B,B,B,B,B,B,B,B,B,B